[
  {
    "type": "mapgen",
    "method": "json",
    "om_terrain": [ [ "urban_11_1", "urban_11_2" ] ],
    "object": {
      "fill_ter": "t_floor",
      "rows": [
        "........________.....`p.........................",
        "......%.________.%...`...........[..............",
        "........________.....`..........................",
        "......%.________.%...`..........................",
        "........________.....`..................[.......",
        "..[...%.________.%...`.....[....................",
        "........________....```.........................",
        "......%.________```````.........................",
        "........________&...```.%!%!.!%%%!.!%%..........",
        ".....!##========#####*#o#######o#####%..........",
        ".....%#'''''''''&|Q +   L RR HH  ETy#!..........",
        ".....%o''''''''''||||        H l   x#.......[...",
        ".....%#''''''''''+'g|        H     s#...........",
        ".....!#q'''''''''||||+| |<    000   o...........",
        "......#q'''''''''|¨¨¨¨| |||  |JJJ|||#...........",
        "......#q''''Á''''|9t8S|˙|66˙˙˙˙˙˙˙˙F#...........",
        ".....^#''''''''''||||||˙˙˙˙˙˙˙˙˙˙˙˙7#^..........",
        ".....!o''''''''A'+    +˙˙˙hffh˙˙˙˙˙5o!..........",
        ".....%#U''''''NN'|ZWĴ |Y˙˙hffh˙43O21#%..........",
        ".....%#############o#*#####oo########%..........",
        ".....%%%!..........`````.!%%%%!...!%%%..........",
        ".................u.`````..................[.....",
        "..[.............................................",
        "................................................"
      ],
      "palettes": [
        "standard_domestic_palette",
        "parameterized_linoleum_color_kitchen",
        "parameterized_linoleum_color_bathroom",
        "standard_domestic_landscaping_palette"
      ],
      "terrain": {
        "=": "t_door_metal_locked",
        "&": "t_gates_mech_control",
        "'": "t_thconc_floor",
        "q": "t_thconc_floor",
        "N": "t_thconc_floor",
        "A": "t_thconc_floor",
        "Á": "t_thconc_floor",
        "g": "t_thconc_floor",
        "U": "t_thconc_floor",
        "Y": { "param": "linoleum_color_kitchen", "fallback": "t_linoleum_white" },
        "h": { "param": "linoleum_color_kitchen", "fallback": "t_linoleum_white" },
        "f": { "param": "linoleum_color_kitchen", "fallback": "t_linoleum_white" },
        "Q": "t_floor",
        "J": "t_floor"
      },
      "furniture": { "0": "f_stool", "Ĵ": "f_counter" },
      "place_loot": [ { "item": "stereo", "x": 35, "y": 11, "chance": 65 }, { "item": "television", "x": 35, "y": 11, "chance": 100 } ],
      "vehicles": { "Á": { "vehicle": "suburban_home", "chance": 100, "rotation": 90 } }
    }
  },
  {
    "type": "mapgen",
    "method": "json",
    "om_terrain": [ [ "urban_11_3", "urban_11_4" ] ],
    "object": {
      "fill_ter": "t_floor",
      "rows": [
        "~~~~~~~~~~~~~~~~~~~~~~~~~~~~~~~~~~~~~~~~~~~~~~~~",
        "~~~~~~~~~~~~~~~~~~~~~~~~~~~~~~~~~~~~~~~~~~~~~~~~",
        "~~~~~~~~~~~~~~~~~~~~~~~~~~~~~~~~~~~~~~~~~~~~~~~~",
        "~~~~~~~~~~~~~~~~~~~~~~~~~~~~~~~~~~~~~~~~~~~~~~~~",
        "~~~~~~~~~~~~~~~~~~~~~~~~~~~~~~~~~~~~~~~~~~~~~~~~",
        "~~~~~~~~~~~~~~~~~~~~~~~~~~~~~~~~~~~~~~~~~~~~~~~~",
        "~~~~~~~~~~~~~~~~~~~~~~~~~~~~~~~~~~~~~~~~~~~~~~~~",
        "~~~~~~~~~~~~~~~~~~~~~~~~~~~~~~~~~~~~~~~~~~~~~~~~",
        "~~~~~~~~~~~~~~~~~~~~~~~~~~~~~~~~~~~~~~~~~~~~~~~~",
        "~~~~~~===============================~~~~~~~~~~~",
        "~~~~~~====#oo#=====#ooo#=====#oo#====~~~~~~~~~~~",
        "~~~~~~#####ii#######iii#######HH#####~~~~~~~~~~~",
        "~~~~~~# bd   III|         +     ddbD#~~~~~~~~~~~",
        "~~~~~~#¤      hI| |||||||>|         #~~~~~~~~~~~",
        "~~~~~~o@@       + |8S8S8|||         o~~~~~~~~~~~",
        "~~~~~^#@@      D|||¨¨¨¨¨| +      @@ #^~~~~~~~~~~",
        "~~~~~~#¤        +¨¨¨¨¨¨t|D|RR   ¤@@¤#~~~~~~~~~~~",
        "~~~~~~#####HH#######¨BB#######ii#####~~~~~~~~~~~",
        "~~~~~~====#oo#=====#ooo#=====#oo#====~~~~~~~~~~~",
        "~~~~~~===============================~~~~~~~~~~~",
        "~~~~~~~~~~~~~~~~~~~~~~~~~~~~~~~~~~~~~~~~~~~~~~~~",
        "~~~~~~~~~~~~~~~~~~~~~~~~~~~~~~~~~~~~~~~~~~~~~~~~",
        "~~~~~~~~~~~~~~~~~~~~~~~~~~~~~~~~~~~~~~~~~~~~~~~~",
        "~~~~~~~~~~~~~~~~~~~~~~~~~~~~~~~~~~~~~~~~~~~~~~~~"
      ],
      "palettes": [ "standard_domestic_palette", "parameterized_linoleum_color_bathroom" ],
      "terrain": { "~": "t_open_air", "=": "t_shingle_flat_roof" }
    }
  },
  {
    "type": "mapgen",
    "method": "json",
    "om_terrain": [ [ "urban_11_5", "urban_11_6" ] ],
    "object": {
      "fill_ter": "t_shingle_flat_roof",
      "rows": [
        "                                                ",
        "                                                ",
        "                                                ",
        "                                                ",
        "                                                ",
        "                                                ",
        "                                                ",
        "                                                ",
        "                                                ",
        "                                                ",
        "          ----     -----     ----               ",
        "      -----..-------...-------..-----           ",
        "      -.............................-           ",
        "      -...N.........................-           ",
        "      -........................&....-           ",
        "      -.................=...........-           ",
        "      5.............................5           ",
        "      -----..-------...-------..-----           ",
        "          ----     -----     ----               ",
        "                                                ",
        "                                                ",
        "                                                ",
        "                                                ",
        "                                                "
      ],
      "palettes": [ "roof_palette" ],
      "terrain": { ".": "t_shingle_flat_roof" },
      "place_nested": [ { "chunks": [ "NC_res_roof_solar_4X4" ], "x": 13, "y": 12 } ]
    }
  }
]
