[
  {
    "type": "mapgen",
    "method": "json",
    "om_terrain": [ [ "urban_12_1", "urban_12_2" ] ],
    "object": {
      "fill_ter": "t_floor",
      "rows": [
        "..............``p...............________........",
        "...[.........%``%...............________........",
        "...........!!````!!.............________..[.....",
        "....!%!!%!.##````##.!%!!%!......________........",
        "...###oo#####o**o#####oo###....&________........",
        "..%#RR    T|      |c      #...##========##^.....",
        "..!o      E|Ls       hffh #...#&'''''''''#......",
        "..%# HHHH  |||    |  hffh #...o''''''''''#%.....",
        "...#E ll    y|  |<|  hffh #%!%#''''''''''o!.....",
        "..%#            |||       #%%%#''''''''''#%.....",
        "..!o            +w|yMy    ##o##''''''''''#......",
        "..%# sxxs   y|  ||||||||  |U'g|'''''Á''''#%.....",
        "..^######oo###   ciic     +'''+''''''''''o!.....",
        "....$'GKG''''#            |Z'W|'''''''''N#%.....",
        "....$''''''''*˙˙˙˙˙˙˙˙||+|##*##qqq'''''AN#......",
        "....€''''''''#Y˙˙˙˙˙˙6|¨¨¨#```####o##o####......",
        "....$ŷ'₸''₸''on˙JJ˙˙˙6|S¨t#```....!%%!......[...",
        "....$''''''''o5˙JJ˙˙˙˙||||#```..................",
        "....$''ŷ''ŷ''#2˙˙˙˙˙˙˙+˙˙˙#.....................",
        "....#$$$€$$$$#17O43FJJ|666#.u...................",
        ".............##o####o######.........[...........",
        "..............%!%..%!%..........................",
        ".....[....................................[.....",
        "................................................"
      ],
      "palettes": [
        "standard_domestic_palette",
        "parameterized_linoleum_color_kitchen",
        "parameterized_linoleum_color_bathroom",
        "standard_domestic_landscaping_palette"
      ],
      "terrain": {
        "=": "t_door_metal_locked",
        "&": "t_gates_mech_control",
        "'": "t_thconc_floor",
        "q": "t_thconc_floor",
        "N": "t_thconc_floor",
        "A": "t_thconc_floor",
        "Á": "t_thconc_floor",
        "U": "t_thconc_floor",
        "W": "t_thconc_floor",
        "Z": "t_thconc_floor",
        "g": "t_thconc_floor",
        "K": "t_thconc_floor",
        "G": "t_thconc_floor",
        "₸": "t_thconc_floor",
        "ŷ": "t_thconc_floor",
        "Y": { "param": "linoleum_color_kitchen", "fallback": "t_linoleum_white" },
        "$": "t_screened_porch_wall",
        "€": "t_screen_door_c",
        "w": "t_floor"
      },
      "furniture": { "ŷ": [ "f_indoor_plant", "f_indoor_plant_y" ] },
      "place_loot": [ { "item": "stereo", "x": 7, "y": 11, "chance": 65 }, { "item": "television", "x": 7, "y": 11, "chance": 100 } ],
      "vehicles": { "Á": { "vehicle": "suburban_home", "chance": 100, "rotation": 90 } }
    }
  },
  {
    "type": "mapgen",
    "method": "json",
    "om_terrain": [ [ "urban_12_3", "urban_12_4" ] ],
    "object": {
      "fill_ter": "t_floor",
      "rows": [
        "~~~~~~~~~~~~~~~~~~~~~~~~~~~~~~~~~~~~~~~~~~~~~~~~",
        "~~~~~~~~~~~~~~~~~~~~~~~~~~~~~~~~~~~~~~~~~~~~~~~~",
        "~~~~~~~~~~~~~~~~~~~~~~~~~~~~~~~~~~~~~~~~~~~~~~~~",
        "~~~~~~~~~~~========~~~~~~~~~~~~~~~~~~~~~~~~~~~~~",
        "~~~##o###o###o##########o##~~~~~~~~~~~~~~~~~~~~~",
        "~~~#T  ¤@@¤   dd|D|B¨t|R T#~~~#####o##o###~~~~~~",
        "~~~#E   @@      + |B¨8|R E#~~~#98|    sdD#^~~~~~",
        "~~~o            |||¨¨S|  s#~~~#¨¨+       #~~~~~~",
        "~~~#           b|>||+||   #~~~#tS|       o~~~~~~",
        "~~~o            |         #~~~#|||      ¤#~~~~~~",
        "~~~#Ih          +         #:::#  +     @@#~~~~~~",
        "~~^#III         |||||||    iii   ||||||||#~~~~~~",
        "~~~###o###o###|||t8S8B|          |RRR   r#~~~~~~",
        "~~~~=========#D |¨¨¨¨B|y   iii   +     hro~~~~~~",
        "~~~~=========#|+|||+||||+|#:::#yy|  PP rr#~~~~~~",
        "~~~~=========#           d#~~~#####o##o###~~~~~~",
        "~~~~=========#           bo~~~~~~~~~~~~~~~~~~~~~",
        "~~~~=========o           d#~~~~~~~~~~~~~~~~~~~~~",
        "~~~~=========#Ih    @@    o~~~~~~~~~~~~~~~~~~~~~",
        "~~~~=========#III  ¤@@¤   #~~~~~~~~~~~~~~~~~~~~~",
        "~~~~~~~~~~~~~###o######o###~~~~~~~~~~~~~~~~~~~~~",
        "~~~~~~~~~~~~~~~~~~~~~~~~~~~~~~~~~~~~~~~~~~~~~~~~",
        "~~~~~~~~~~~~~~~~~~~~~~~~~~~~~~~~~~~~~~~~~~~~~~~~",
        "~~~~~~~~~~~~~~~~~~~~~~~~~~~~~~~~~~~~~~~~~~~~~~~~"
      ],
      "palettes": [ "standard_domestic_palette", "parameterized_linoleum_color_bathroom" ],
      "terrain": { "~": "t_open_air", "=": "t_shingle_flat_roof" }
    }
  },
  {
    "type": "mapgen",
    "method": "json",
    "om_terrain": [ [ "urban_12_5", "urban_12_6" ] ],
    "object": {
      "fill_ter": "t_shingle_flat_roof",
      "rows": [
        "                                                ",
        "                                                ",
        "                                                ",
        "                                                ",
        "   ------------------------                     ",
        "   -......................-   -----------5      ",
        "   -......................-   -..........-      ",
        "   -.............=........-   -..........-      ",
        "   -..........N...........-   -..........-      ",
        "   -......................-   -.=........-      ",
        "   -......................-----..........-      ",
        "   -.....................................-      ",
        "   5----------......................:....-      ",
        "             -...........................-      ",
        "             -............-----..........-      ",
        "             -............-   ------------      ",
        "             -.......&....-                     ",
        "             -............-                     ",
        "             -............-                     ",
        "             -............-                     ",
        "             --------------                     ",
        "                                                ",
        "                                                ",
        "                                                "
      ],
      "palettes": [ "roof_palette" ],
      "terrain": { ".": "t_shingle_flat_roof" },
      "place_nested": [ { "chunks": [ "NC_res_roof_solar_4X4" ], "x": 7, "y": 6 } ]
    }
  }
]
