[
  {
    "type": "mapgen",
    "method": "json",
    "om_terrain": [ [ "urban_15_1", "urban_15_2" ] ],
    "object": {
      "fill_ter": "t_floor",
      "rows": [
        "....p._______...................................",
        "......_______...................................",
        "..[..._______````````````````````````````````...",
        "......_______```..!!..```....!%!!%!.........`.[.",
        ".....&_______```!!%%!!```#####o##o#######...`...",
        "....##=======#*##oooo##*##D|II¤@@¤ |8¨BB#!..`...",
        "....#&'''''''''|4n5321  L| + h @@  |S¨¨¨o%..`...",
        "....#''''''''''|7˙˙˙˙˙   |||      E|S¨¨t#!..`...",
        "....#U'''''''''|O˙JJ0˙   +6|ydb   T|8¨¨¨#...`...",
        "....#q'''''''''|J˙JJ0˙   ||||||||+|||+||#...`...",
        "....#q''''Á''''|J˙JJ0˙     <          |D#...`...",
        "...^#N'''''''''|F˙˙˙˙˙                | #...`...",
        "....#NA''''''''|           sE  y||+||||+#...`...",
        "....#||||||||+||  hffh     H   x|T  dbd #...`...",
        "$$$$#g            hffh     H l x|       #$$$€$$$",
        "$...#Ĵ   ||+||+|  hffh     H   x|  @@   #......$",
        "$...#ĴĴZW|S¨t|w|Y       RR HH  T|y¤@@¤  #......$",
        "$...##oo#########o#**#o####ooo####o###o##^.....$",
        "$................``````...!!%!!................$",
        "$............u...``````...................[....$",
        "$........[...........................X.........$",
        "$...........................[..................$",
        "$..............................................$",
        "$$$$$$$$$$$$$$$$$$$$$$$$$$$$$$$$$$$$$$$$$$$$$$$$"
      ],
      "palettes": [
        "standard_domestic_palette",
        "parameterized_linoleum_color_kitchen",
        "parameterized_linoleum_color_bathroom",
        "standard_domestic_landscaping_palette"
      ],
      "terrain": {
        "=": "t_door_metal_locked",
        "&": "t_gates_mech_control",
        "'": "t_thconc_floor",
        "q": "t_thconc_floor",
        "N": "t_thconc_floor",
        "A": "t_thconc_floor",
        "Á": "t_thconc_floor",
        "U": "t_thconc_floor",
        "$": "t_privacy_fence",
        "€": "t_privacy_fencegate_c",
        "0": { "param": "linoleum_color_kitchen", "fallback": "t_linoleum_white" },
        "w": "t_floor",
        "6": "t_floor"
      },
      "furniture": { "0": "f_stool", "Ĵ": "f_counter" },
      "place_loot": [ { "item": "stereo", "x": 31, "y": 14, "chance": 65 }, { "item": "television", "x": 31, "y": 14, "chance": 100 } ],
      "vehicles": { "Á": { "vehicle": "suburban_home_compact", "chance": 100, "rotation": 90 } }
    }
  },
  {
    "type": "mapgen",
    "method": "json",
    "om_terrain": [ [ "urban_15_3", "urban_15_4" ] ],
    "object": {
      "fill_ter": "t_floor",
      "rows": [
        "~~~~~~~~~~~~~~~~~~~~~~~~~~~~~~~~~~~~~~~~~~~~~~~~",
        "~~~~~~~~~~~~~~~~~~~~~~~~~~~~~~~~~~~~~~~~~~~~~~~~",
        "~~~~~~~~~~~~~~~~~~~~~~~~~~~~~~~~~~~~~~~~~~~~~~~~",
        "~~~~~~~~~~~~~~~~~~~~~~~~~~~~~~~~~~~~~~~~~~~~~~~~",
        "~~~~~~~~~~~~~~~~~~~~~~~~-----------------~~~~~~~",
        "~~~~---------------------===============-~~~~~~~",
        "~~~~-===================================-~~~~~~~",
        "~~~~-===================================-~~~~~~~",
        "~~~~-===================================-~~~~~~~",
        "~~~~-=============^###oo#########=======-~~~~~~~",
        "~~~~-==============#RR  yb|>|8S8#=======-~~~~~~~",
        "~~~~!==============#      + +¨¨¨o=======-~~~~~~~",
        "~~~~-==============#  @@  |||B¨¨o=======-~~~~~~~",
        "~~~~-==============#d¤@@¤ +D|B¨t#=======-~~~~~~~",
        "~~~~-==============##o##o########=======-~~~~~~~",
        "~~~~-===================================-~~~~~~~",
        "~~~~-===================================-~~~~~~~",
        "~~~~------------------------------------!~~~~~~~",
        "~~~~~~~~~~~~~~~~~~~~~~~~~~~~~~~~~~~~~~~~~~~~~~~~",
        "~~~~~~~~~~~~~~~~~~~~~~~~~~~~~~~~~~~~~~~~~~~~~~~~",
        "~~~~~~~~~~~~~~~~~~~~~~~~~~~~~~~~~~~~~~~~~~~~~~~~",
        "~~~~~~~~~~~~~~~~~~~~~~~~~~~~~~~~~~~~~~~~~~~~~~~~",
        "~~~~~~~~~~~~~~~~~~~~~~~~~~~~~~~~~~~~~~~~~~~~~~~~",
        "~~~~~~~~~~~~~~~~~~~~~~~~~~~~~~~~~~~~~~~~~~~~~~~~"
      ],
      "palettes": [ "standard_domestic_palette", "parameterized_linoleum_color_bathroom" ],
      "terrain": { "~": "t_open_air", "=": "t_shingle_flat_roof", "!": "t_gutter_drop", "-": "t_gutter" }
    }
  },
  {
    "type": "mapgen",
    "method": "json",
    "om_terrain": [ [ "urban_15_5", "urban_15_6" ] ],
    "object": {
      "fill_ter": "t_shingle_flat_roof",
      "rows": [
        "                                                ",
        "                                                ",
        "                                                ",
        "                                                ",
        "                                                ",
        "                                                ",
        "                                                ",
        "                                                ",
        "                                                ",
        "                   5-------------               ",
        "                   -............-               ",
        "                   -.N..........-               ",
        "                   -.........:..-               ",
        "                   -............-               ",
        "                   --------------               ",
        "                                                ",
        "                                                ",
        "                                                ",
        "                                                ",
        "                                                ",
        "                                                ",
        "                                                ",
        "                                                ",
        "                                                "
      ],
      "palettes": [ "roof_palette" ],
      "terrain": { ".": "t_shingle_flat_roof" },
      "place_nested": [ { "chunks": [ "NC_res_roof_solar_4X4" ], "x": 24, "y": 10 } ]
    }
  }
]
