[
  {
    "type": "mapgen",
    "method": "json",
    "om_terrain": [ [ "urban_10_1", "urban_10_2" ] ],
    "object": {
      "fill_ter": "t_floor",
      "rows": [
        ".......................``p......................",
        ".......................``````````````````````...",
        "....[..................``...................`...",
        "........!%%%!!%%%!...[.``.[...!%%%!!%%%!....`...",
        ".......###o####o###....``....##ooo##ooo##...`...",
        "......!#y        R#!!!!``!!!!#y        y#!..`...",
        "......%os    HH  R#``````````#M  hffh   o%..`...",
        "......%#x  l  H  R#``````````#M  hffh   o%..`...",
        "......%#x  l  H   ###o#**#o###y  hffh   o%..`...",
        "......%os     H    iiiL   iii          R#!..`.[.",
        "......!#y  TE                          R#...`...",
        "..[...^#|||||||+||||+||  ||+||˙˙˙AA˙4|||#^..`...",
        "......%#R        T|S¨t| <|q U|˙˙˙JJ˙F|˙6#%..`...",
        "$$$$$$$#   rh    E############Y˙˙˙˙˙˙+˙6#$$$€$$$",
        "$.....%#R  rrrP   *`````GKG``#7˙325O1|˙6#%..`..$",
        "$......##o######o##``````````##*##o######...`..$",
        "$......!%%%!...``````~~~~~~``````%%%........`..$",
        "$.[............```~~~~~~~~~~~~```.....[...X.`..$",
        "$..........[...`₸`~~~~~~~~~~~~```...........`..$",
        "$..............```~~~~~~~~~~~~```````````````..$",
        "$..............`₸`~~~~~~~~~~~~```..............$",
        "$......[.......```~~~~~~~~~~~~```....u.....[...$",
        "$..............``````````````````..............$",
        "$$$$$$$$$$$$$$$$$$$$$$$$$$$$$$$$$$$$$$$$$$$$$$$$"
      ],
      "palettes": [
        "standard_domestic_palette",
        "parameterized_linoleum_color_kitchen",
        "parameterized_linoleum_color_bathroom",
        "standard_domestic_landscaping_palette"
      ],
      "terrain": {
        "~": "t_water_pool_outdoors",
        "K": "t_concrete",
        "G": "t_concrete",
        "₸": "t_concrete",
        "$": "t_privacy_fence",
        "€": "t_privacy_fencegate_c",
        "Y": { "param": "linoleum_color_kitchen", "fallback": "t_linoleum_white" },
        "A": { "param": "linoleum_color_kitchen", "fallback": "t_linoleum_white" }
      },
      "place_loot": [ { "item": "stereo", "x": 8, "y": 7, "chance": 65 }, { "item": "television", "x": 8, "y": 7, "chance": 100 } ]
    }
  },
  {
    "type": "mapgen",
    "method": "json",
    "om_terrain": [ [ "urban_10_3", "urban_10_4" ] ],
    "object": {
      "fill_ter": "t_floor",
      "rows": [
        "~~~~~~~~~~~~~~~~~~~~~~~~~~~~~~~~~~~~~~~~~~~~~~~~",
        "~~~~~~~~~~~~~~~~~~~~~~~~~~~~~~~~~~~~~~~~~~~~~~~~",
        "~~~~~~~~~~~~~~~~~~~~~~~~~~~~~~~~~~~~~~~~~~~~~~~~",
        "~~~~~~~~~~~~~~~~~~~~~~~~~~~~~~~~~~~~~~~~~~~~~~~~",
        "~~~~~~~####o##o####~~~~~~~~~~####o##o####~~~~~~~",
        "~~~~~~~#RRR Yssy R#~~~~~~~~~~#D| ¤@@¤ b #~~~~~~~",
        "~~~~~~~o          o~~~~~~~~~~# +  @@    o~~~~~~~",
        "~~~~~~~#R        R#~~~~~~~~~~#D|        #~~~~~~~",
        "~~~~~~~#R  EsE    ###o####o###||       d#~~~~~~~",
        "~~~~~~~#R             yiiy     +       d#~~~~~~~",
        "~~~~~~^#|||||||||+|          |+|||dd||+|#^~~~~~~",
        "~~~~~~~#III  Tdd  |||+|  |+|||¨¨S||||t¨S#~~~~~~~",
        "~~~~~~~#Ih        +D|U|c>|q|w+¨¨8|w¨+¨¨8#~~~~~~~",
        "~~~~~~~o     @   @############B¨t||||¨¨¨o~~~~~~~",
        "~~~~~~~#    ¤@  ¤@#~~~~~~~~~~#B¨¨+ U|¨BB#~~~~~~~",
        "~~~~~~~###o####o###~~~~~~~~~~###o####o###~~~~~~~",
        "~~~~~~~~~~~~~~~~~~~~~~~~~~~~~~~~~~~~~~~~~~~~~~~~",
        "~~~~~~~~~~~~~~~~~~~~~~~~~~~~~~~~~~~~~~~~~~~~~~~~",
        "~~~~~~~~~~~~~~~~~~~~~~~~~~~~~~~~~~~~~~~~~~~~~~~~",
        "~~~~~~~~~~~~~~~~~~~~~~~~~~~~~~~~~~~~~~~~~~~~~~~~",
        "~~~~~~~~~~~~~~~~~~~~~~~~~~~~~~~~~~~~~~~~~~~~~~~~",
        "~~~~~~~~~~~~~~~~~~~~~~~~~~~~~~~~~~~~~~~~~~~~~~~~",
        "~~~~~~~~~~~~~~~~~~~~~~~~~~~~~~~~~~~~~~~~~~~~~~~~",
        "~~~~~~~~~~~~~~~~~~~~~~~~~~~~~~~~~~~~~~~~~~~~~~~~"
      ],
      "palettes": [ "standard_domestic_palette", "parameterized_linoleum_color_bathroom" ],
      "terrain": { "~": "t_open_air" }
    }
  },
  {
    "type": "mapgen",
    "method": "json",
    "om_terrain": [ [ "urban_10_5", "urban_10_6" ] ],
    "object": {
      "fill_ter": "t_shingle_flat_roof",
      "rows": [
        "                                                ",
        "                                                ",
        "                                                ",
        "                                                ",
        "       ------------          ------------       ",
        "       -..........-          -..........-       ",
        "       -..........-          -..........-       ",
        "       -..........-          -......&...-       ",
        "       -..........------------..........-       ",
        "       -................................-       ",
        "       5........X.......................5       ",
        "       -..........................=.....-       ",
        "       -................................-       ",
        "       -..........------------..........-       ",
        "       -..........-          -..........-       ",
        "       ------------          ------------       ",
        "                                                ",
        "                                                ",
        "                                                ",
        "                                                ",
        "                                                ",
        "                                                ",
        "                                                ",
        "                                                "
      ],
      "palettes": [ "roof_palette" ],
      "terrain": { ".": "t_shingle_flat_roof" },
      "place_nested": [ { "chunks": [ "NC_res_roof_solar_4X4" ], "x": 9, "y": 6 } ]
    }
  }
]
