[
  {
    "//": "nano_fabricator room",
    "type": "mapgen",
    "method": "json",
    "om_terrain": [ "lab_finale_1level" ],
    "weight": 100,
    "object": {
      "fill_ter": "t_thconc_floor",
      "rows": [
        "CCC..................CCC",
        "C..........YY..........C",
        "........................",
        "....cc............cc....",
        "....cc..c......c..cc....",
        "....cc..c..//..c..cc....",
        "........c..//..c........",
        "........c......c........",
        "...........YY...........",
        "........................",
        ".....-----gGGg-----.....",
        ".....-c.g,,,,,,g.c-.....",
        "..YY.-c.G,/,,/,G.c-.YY..",
        ".....-c.g,?,,?,g.c-.....",
        "ggGGg----,,,,,,----gGGgg",
        ".x...-CC-+gggg+-CC-...x.",
        ".x..x-,,,,,,,,,,,,-x..x.",
        ".x..C-,r,,,rr,,,r,-C..x.",
        ".x..C-Y,,,,,,,,,,Y-C..x.",
        ".x..x----GggggG----x..x.",
        ".R....G..........G....R.",
        "......G....YY....G......",
        ".Yxx..g..........g..xxY.",
        "......g..........g......"
      ],
      "palettes": [ "lab_palette", "lab_loot_research" ],
      "furniture": { "R": "f_rack" },
      "terrain": { "?": "t_nanofab", "r": "t_metal_floor", "/": "t_nanofab_body" },
      "mapping": { "r": { "item": { "item": "standard_template_construct" } }, "R": { "item": { "item": "nanomaterial" } } },
      "place_nested": [ { "chunks": [ "lab_finale_loot" ], "x": 6, "y": 11 } ],
      "place_loot": [
        { "group": "mech_power_cell_spawn", "x": [ 4, 5 ], "y": [ 3, 5 ] },
        { "item": "id_science", "x": 17, "y": [ 11, 13 ] }
      ],
      "place_monster": [
        { "monster": "mon_secubot", "x": [ 1, 4 ], "y": [ 20, 22 ], "chance": 90 },
        { "monster": "mon_secubot", "x": [ 19, 20 ], "y": [ 20, 22 ], "chance": 90 },
        { "monster": "mon_zombie_scientist", "x": [ 2, 20 ], "y": [ 1, 9 ], "chance": 90, "repeat": [ 1, 2 ] },
        { "monster": "mon_mech_lifter", "x": 2, "y": 2, "chance": 100 }
      ]
    }
  },
  {
    "//": "superalloy forge room",
    "type": "mapgen",
    "method": "json",
    "om_terrain": [ "lab_finale_1level" ],
    "weight": 100,
    "object": {
      "fill_ter": "t_thconc_floor",
      "rows": [
        "CCC..................CCC",
        "C..........YY..........C",
        "........................",
        "....mmm..........mmm....",
        "....mmm..........mmm....",
        "....mmm..........mmm....",
        "........................",
        "........................",
        "...........YY...........",
        "........................",
        "........../../..........",
        "........../../..........",
        "..YY....../../......YY..",
        "..........?..?..........",
        ".....y---......----gGGgg",
        ".....y-r-+gggg+-CC-...x.",
        ".....y-r,,,,,,,,,r-x..x.",
        ".....y-r,,,,,,,,,r-C..x.",
        ".....y-r,,,,,,,,,Y-C..x.",
        ".....y---GggggG----x..x.",
        ".................G....R.",
        "...........YY....G......",
        ".Y...............g..xxY.",
        ".................g......"
      ],
      "palettes": [ "lab_palette", "lab_loot_research" ],
      "furniture": { "R": "f_rack", "m": [ "f_cardboard_box", "f_crate_c" ], "y": "f_crate_c" },
      "terrain": { "?": "t_nanoforge", "r": "t_metal_floor", "/": "t_nanoforge_body" },
      "mapping": { "R": { "item": { "item": "nanomaterial" } } },
      "place_nested": [ { "chunks": [ "lab_finale_loot" ], "x": 7, "y": 15 } ],
      "place_loot": [ { "item": "id_science", "x": 17, "y": [ 16, 17 ] } ],
      "items": {
        "m": { "item": "sheet_metal", "chance": 50, "repeat": [ 1, 2 ] },
        "y": { "item": "alloy_sheet", "chance": 100, "repeat": [ 1, 2 ] }
      },
      "place_monster": [
        { "monster": "mon_secubot", "x": [ 1, 4 ], "y": [ 10, 12 ], "chance": 90 },
        { "monster": "mon_secubot", "x": [ 19, 20 ], "y": [ 20, 22 ], "chance": 90 },
        { "monster": "mon_zombie_scientist", "x": [ 2, 20 ], "y": [ 1, 9 ], "chance": 90, "repeat": [ 1, 2 ] },
        { "monster": "mon_mech_lifter", "x": 2, "y": 2, "chance": 100 }
      ]
    }
  },
  {
    "//": "triffid room",
    "type": "mapgen",
    "method": "json",
    "om_terrain": [ "lab_finale_1level" ],
    "weight": 50,
    "object": {
      "fill_ter": "t_thconc_floor",
      "rows": [
        "CCC..................CCC",
        "C......................C",
        "..cccccccc....cccccccc..",
        "........................",
        ".............6..........",
        ".....------LL------.....",
        ".....-,,,,,,,,,,,,-.....",
        ".....-,,,,,,,,,,,,-.....",
        ".....-,,,,,,,,,,,,-.....",
        "....r-,,,,,,,,,,,,-r....",
        "....r-,,,,,,,,,,,,-r....",
        "....r-,,,,,,,,,,,,-r....",
        "....r-,,,,,,,,,,,,-r....",
        "....r-,,,,,,,,,,,,-r....",
        "....r-,,,,,,,,,,,,-r....",
        ".....-,,,,,,,,,,,,-.....",
        ".....-,,,,,,,,,,,,-.....",
        ".....-,,,,,,,,,,,,-.....",
        ".....--------------.....",
        "........................",
        "........................",
        "..cccccccc....cccccccc..",
        "C......................C",
        "CCC..................CCC"
      ],
      "palettes": [ "lab_palette", "lab_loot_research" ],
      "furniture": { "R": "f_rack" },
      "terrain": { ",": "t_grass" },
      "place_nested": [ { "chunks": [ "lab_finale_loot" ], "x": 4, "y": 11 } ],
      "place_loot": [ { "item": "id_science", "x": 19, "y": [ 11, 13 ] } ],
      "place_monster": [ { "monster": "mon_triffid_radiant_boss", "x": 12, "y": 12, "chance": 100 } ],
      "computers": { "6": { "name": "High Risk Subject Containment", "options": [ { "name": "UNLOCK ENTRANCE", "action": "unlock" } ] } }
    }
  },
  {
    "//": "medical mutant room",
    "type": "mapgen",
    "method": "json",
    "om_terrain": [ "lab_finale_1level" ],
    "weight": 50,
    "object": {
      "fill_ter": "t_thconc_floor",
      "rows": [
        "CCC..................CCC",
        "C......................C",
        "..cccccccc....cccccccc..",
        "........................",
        ".............6..........",
        ".....------LL------.....",
        ".....-,,,,,,,,,,,,-.....",
        ".....-,,,,,,,,,,,,-.....",
        ".....-,,,,,,,,,,,,-.....",
        "....r-,,,,,,,,,,,,-r....",
        "....r-,,,,,,,,,,,,-r....",
        "....r-,,,,,,,,,,,,-r....",
        "....r-,,,,,,,,,,,,-r....",
        "....r-,,,,,,,,,,,,-r....",
        "....r-,,,,,,,,,,,,-r....",
        ".....-,,,,,,,,,,,,-.....",
        ".....-,,,,,,,,,,,,-.....",
        ".....-,,,,,,,,,,,,-.....",
        ".....--------------.....",
        "........................",
        "........................",
        "..cccccccc....cccccccc..",
        "C......................C",
        "CCC..................CCC"
      ],
      "palettes": [ "lab_palette", "lab_loot_research" ],
      "furniture": { "R": "f_rack" },
      "terrain": { ",": "t_metal_floor" },
      "place_nested": [ { "chunks": [ "lab_finale_loot" ], "x": 4, "y": 11 } ],
      "place_loot": [ { "item": "id_science", "x": 19, "y": [ 11, 13 ] } ],
      "place_monster": [ { "monster": "mon_mutant_medical", "x": 12, "y": 12, "chance": 100 } ],
      "computers": { "6": { "name": "High Risk Subject Containment", "options": [ { "name": "UNLOCK ENTRANCE", "action": "unlock" } ] } }
    }
  },
  {
    "//": "portal room",
    "type": "mapgen",
    "method": "json",
    "om_terrain": [ "lab_finale_1level" ],
    "weight": 50,
    "object": {
      "fill_ter": "t_thconc_floor",
      "rows": [
        ".....,...g.....xxxxxxxxx",
        ".r..r,..ig.YY...........",
        ".r..r,..tg.....dd..tt...",
        ".rY.r,..tg.....xh..tt.Y.",
        ".rY.r,.. G.....d...tt.Y.",
        ".R..r,...G.........tt...",
        ".....,..tg..............",
        "-+-l,,..tg.....d........",
        "..-l....tggGGggdh.......",
        "..-lll...G,,,,gd........",
        "..-----g-ggGGgg-gggGg-+-",
        "..-,,,,xgY,,,,Y-....l-..",
        "..-,,,hxg,,,,,,-dDd.l-..",
        "..-,,,,xg,,,,,,-.h..l-..",
        "-+--+----,,,,,,-------+-",
        ".....-CCC,,,,,,CCC-....C",
        ".....g,,,,,,,,,,,,gx...C",
        ".....g,,,,CQQC,,,,gC...C",
        ".....-Y,,,,,,,,,,Y-C...C",
        "-+-------GggggG-------+-",
        ".......................-",
        ".......................-",
        ".CCCCxxxxA....ACCxxCCCx-",
        "........................"
      ],
      "palettes": [ "lab_palette", "lab_loot_research" ],
      "furniture": { "R": "f_rack", "D": "f_desk", "A": "f_artifact_analyzer_console" },
      "fields": { "Q": { "field": "fd_fatigue", "intensity": 3 } },
      "mapping": {
        "R": { "item": [ { "item": "dimensional_anchor" }, { "item": "phase_immersion_suit" } ] },
        "D": {
          "item": [
            { "item": "sample_t_substrate" },
            { "item": "log_immersion27" },
            { "item": "HAADF_t_substrate" },
            { "item": "report_t_substrate" }
          ]
        }
      },
      "place_nested": [ { "chunks": [ "lab_finale_loot" ], "x": 4, "y": 1 } ],
      "place_loot": [ { "item": "id_science", "x": [ 19, 20 ], "y": [ 2, 5 ] } ],
      "place_monster": [ { "monster": "mon_mech_lifter", "x": 2, "y": 2, "chance": 100 } ]
    }
  },
  {
    "//": "resonance cascade finale",
    "type": "mapgen",
    "method": "json",
    "om_terrain": [ "lab_finale_1level" ],
    "weight": 100,
    "object": {
      "fill_ter": "t_thconc_floor",
      "rows": [
        "........................",
        ".....Y............Y.....",
        "........................",
        "-MM|----------------|MM-",
        "...|C.....o..oCCCCCC|...",
        "...|C...............|...",
        "...|C.Y...o..o...Y..|...",
        "...|C.......6.......|...",
        "...|-..............-|...",
        "..Y..................Y..",
        "..Y..................Y..",
        "...|gggggg----gggggg|...",
        "...|txttttCCCCtttxxt|...",
        "...|r.hh........h .r|...",
        "...|r.Y..........Y.r|...",
        "...|r..|---MM---|..r|...",
        "-MM|---|........|---|MM-",
        "........................",
        "...........?............",
        "........................",
        "....Y..............Y....",
        "........................",
        "........................",
        "........................"
      ],
      "palettes": [ "lab_palette" ],
      "monster": { "?": { "monster": "mon_shade_boss" } },
      "terrain": { "o": "t_radio_tower" },
      "computers": {
        "6": {
          "name": "Sub-prime Contact Console",
          "access_denied": "ERROR!  Access denied!  Unauthorized access will be met with lethal force!",
          "security": 2,
          "options": [
            { "name": "Toggle Portal", "action": "portal", "security": 8 },
            { "name": "Activate Resonance Cascade", "action": "cascade", "security": 10 }
          ],
          "failures": [ { "action": "damage" }, { "action": "secubots" } ]
        }
      },
      "place_nested": [ { "chunks": [ "lab_finale_loot" ], "x": 4, "y": 13 } ],
      "place_loot": [ { "item": "id_science", "x": [ 14, 16 ], "y": 12 } ]
    }
  },
  {
    "//": "cvd forge",
    "type": "mapgen",
    "method": "json",
    "om_terrain": [ "lab_finale_1level" ],
    "weight": 100,
    "object": {
      "fill_ter": "t_thconc_floor",
      "rows": [
        "........................",
        "........................",
        "..Y..................Y..",
        "........................",
        ".........|---------|....",
        ".........|Y......tt|....",
        ".....?...|..oooo.hx|....",
        "....|--|M|..oooo..C|....",
        "....|r.M....Oooo..C|....",
        "....|r*|xh..oooo..C|....",
        "....|rY|ttt......YC|....",
        "....|--|-----------|....",
        "........................",
        "..Y..................Y..",
        "........................",
        "........................",
        "---------|....|--ggggg--",
        "ttttt.xtt|Y..Y|Y........",
        ".......h.|....g..hhhhh..",
        "....Y....M....G.httttth.",
        "t...Y....M....G.httttth.",
        "th......t|....g..hhhhh..",
        "x......hx|....|.........",
        "---------|....|........."
      ],
      "palettes": [ "lab_palette" ],
      "place_nested": [ { "chunks": [ "lab_finale_loot" ], "x": 5, "y": 8 } ],
      "monster": { "?": { "monster": "mon_turret_light" }, "*": { "monster": "mon_shade_boss", "chance": 50 } },
      "terrain": { "o": "t_cvdbody", "O": "t_cvdmachine" },
      "place_loot": [ { "item": "id_science", "x": [ 8, 10 ], "y": 10 } ]
    }
  },
  {
    "//": "experimental firing range room",
    "type": "mapgen",
    "method": "json",
    "om_terrain": [ "lab_finale_1level" ],
    "weight": 100,
    "object": {
      "fill_ter": "t_thconc_floor",
      "rows": [
        "xxx..................xxx",
        "xhd..................dhx",
        "d.d.----------------.d.d",
        "....|//////////////|....",
        "....|,,,,,,,,,,,,I,|....",
        "....|,,,,,,,,,,,???|....",
        "....|,I,,,III,,I,,,|....",
        "....|/?/,,III,???,,|....",
        "....|I,,,,III,,,,,,|....",
        "....|??,,,,,,,,,,,,|....",
        "....|,,,,,,,,,,,,,,|....",
        "....|,,,,,I,,,,I,,,|....",
        "....|,,,,???,,,,,,,|....",
        "....|,,,,,,,,,,,,,,|....",
        "....|///,,,,,,,,///|....",
        "....|---yyyyyyyy---|....",
        "....gr,,,,,,,,,,,,rg....",
        "....gr,,,,OOOO,,,,rg....",
        "....gr,,,,,,,,,,,,rg....",
        "....gggggggGGggggggg....",
        "........................",
        "ddd.....xxdppdxx.....ddd",
        "xh....................hx",
        "xxx..................xxx"
      ],
      "palettes": [ "lab_palette", "lab_loot_research" ],
      "furniture": {
        "I": "f_target",
        "y": "f_counter",
        "?": "f_sandbag_half",
        "/": "f_sandbag_wall",
        "O": "f_locker",
        "p": "f_control_station"
      },
      "terrain": {
        "?": "t_strconc_floor",
        "r": "t_strconc_floor",
        "/": "t_strconc_floor",
        "O": "t_strconc_floor",
        "I": "t_strconc_floor"
      },
      "place_nested": [ { "chunks": [ "lab_finale_loot" ], "x": 5, "y": 16 }, { "chunks": [ "lab_weapon_loot" ], "x": 8, "y": 15 } ],
      "place_loot": [ { "group": "mech_power_cell_spawn", "x": 18, "y": 17 }, { "item": "id_science", "x": 18, "y": 16 } ],
      "place_monster": [
        { "monster": "mon_secubot", "x": [ 1, 4 ], "y": [ 20, 22 ], "chance": 90 },
        { "monster": "mon_secubot", "x": [ 19, 20 ], "y": [ 20, 22 ], "chance": 90 },
        { "monster": "mon_mech_recon", "x": 8, "y": 17, "chance": 50 }
      ]
    }
  },
  {
    "type": "mapgen",
    "method": "json",
    "nested_mapgen_id": "lab_weapon_loot",
    "weight": 25,
    "object": {
      "mapgensize": [ 8, 3 ],
      "rows": [
        "yIyyyyyy",
        ",,,,,,,,",
        ",,OOO?,,"
      ],
      "palettes": [ "lab_palette" ],
      "furniture": { "y": "f_counter", "O": "f_locker", "I": "f_counter", "?": "f_locker" },
      "terrain": { "O": "t_strconc_floor", "I": "t_strconc_floor", "?": "t_strconc_floor" },
      "mapping": {
        "I": { "item": [ { "item": "plasma_gun", "chance": 100 } ] },
        "O": { "item": [ { "item": "plasma", "chance": 100 } ] },
        "?": { "item": [ { "item": "adv_UPS_off", "chance": 100 }, { "item": "plut_cell", "chance": 100 } ] }
      }
    }
  },
  {
    "type": "mapgen",
    "method": "json",
    "nested_mapgen_id": "lab_weapon_loot",
    "weight": 25,
    "object": {
      "mapgensize": [ 8, 3 ],
      "rows": [
        "yIyyyyyy",
        ",,,,,,,,",
        ",,OOO?,,"
      ],
      "palettes": [ "lab_palette" ],
      "furniture": { "y": "f_counter", "O": "f_locker", "I": "f_counter", "?": "f_locker" },
      "terrain": { "O": "t_strconc_floor", "I": "t_strconc_floor", "?": "t_strconc_floor" },
      "mapping": {
        "I": { "item": [ { "item": "plasma_rifle", "chance": 100 } ] },
        "O": { "item": [ { "item": "plasma", "chance": 100 } ] },
        "?": { "item": [ { "item": "adv_UPS_off", "chance": 100 }, { "item": "plut_cell", "chance": 100 } ] }
      }
    }
  },
  {
    "type": "mapgen",
    "method": "json",
    "nested_mapgen_id": "lab_weapon_loot",
    "weight": 25,
    "object": {
      "mapgensize": [ 8, 3 ],
      "rows": [
        "yIyyyyyy",
        ",,,,,,,,",
        ",,OOO?,,"
      ],
      "palettes": [ "lab_palette" ],
      "furniture": { "y": "f_counter", "O": "f_locker", "I": "f_counter", "?": "f_locker" },
      "terrain": { "O": "t_strconc_floor", "I": "t_strconc_floor", "?": "t_strconc_floor" },
      "mapping": {
        "I": { "item": [ { "item": "emp_gun", "chance": 100 } ] },
        "O": { "item": [ { "item": "plut_cell", "chance": 100, "repeat": [ 2, 2 ] } ] },
        "?": { "item": [ { "item": "adv_UPS_off", "chance": 100, "repeat": [ 2, 2 ] }, { "item": "plut_cell", "chance": 100 } ] }
      }
    }
  },
  {
    "type": "mapgen",
    "method": "json",
    "nested_mapgen_id": "lab_weapon_loot",
    "weight": 25,
    "object": {
      "mapgensize": [ 8, 3 ],
      "rows": [
        "yIyyyyyy",
        ",,,,,,,,",
        ",,OOO?,,"
      ],
      "palettes": [ "lab_palette" ],
      "furniture": { "y": "f_counter", "O": "f_locker", "I": "f_counter", "?": "f_locker" },
      "terrain": { "O": "t_strconc_floor", "I": "t_strconc_floor", "?": "t_strconc_floor" },
      "mapping": {
        "I": { "item": [ { "item": "hk_g80mag", "chance": 100, "repeat": [ 3, 4 ] }, { "item": "hk_g80", "chance": 100 } ] },
        "O": { "item": [ { "item": "12mm", "chance": 100, "repeat": [ 2, 3 ] } ] },
        "?": { "item": [ { "item": "adv_UPS_off", "chance": 100 }, { "item": "plut_cell", "chance": 100 } ] }
      }
    }
  },
  {
    "type": "mapgen",
    "method": "json",
    "nested_mapgen_id": "lab_finale_loot",
    "weight": 25,
    "object": {
      "mapgensize": [ 3, 3 ],
      "rows": [
        "r  ",
        "r  ",
        "R  "
      ],
      "palettes": [ "lab_palette" ],
      "mapping": {
        "r": { "item": [ { "item": "iv_mutagen_medical", "chance": 100, "repeat": [ 2, 2 ] } ] },
        "R": { "item": [ { "item": "purifier_smart_shot", "chance": 100 } ] }
      }
    }
  },
  {
    "type": "mapgen",
    "method": "json",
    "nested_mapgen_id": "lab_finale_loot",
    "weight": 25,
    "object": {
      "mapgensize": [ 3, 3 ],
      "rows": [
        "r  ",
        "r  ",
        "R  "
      ],
      "palettes": [ "lab_palette" ],
      "mapping": {
        "r": { "item": [ { "item": "iv_mutagen_elfa", "chance": 100, "repeat": [ 2, 2 ] } ] },
        "R": { "item": [ { "item": "purifier_smart_shot", "chance": 100 } ] }
      }
    }
  },
  {
    "type": "mapgen",
    "method": "json",
    "nested_mapgen_id": "lab_finale_loot",
    "weight": 25,
    "object": {
      "mapgensize": [ 3, 3 ],
      "rows": [
        "r  ",
        "r  ",
        "R  "
      ],
      "palettes": [ "lab_palette" ],
      "mapping": {
        "r": { "item": [ { "item": "iv_mutagen_alpha", "chance": 100, "repeat": [ 2, 2 ] } ] },
        "R": { "item": [ { "item": "purifier_smart_shot", "chance": 100 } ] }
      }
    }
  },
  {
    "type": "mapgen",
    "method": "json",
    "nested_mapgen_id": "lab_finale_loot",
    "weight": 25,
    "object": {
      "mapgensize": [ 3, 3 ],
      "rows": [
        "r  ",
        "r  ",
        "R  "
      ],
      "palettes": [ "lab_palette" ],
      "mapping": {
        "r": { "items": [ { "item": "books_bank_vault", "chance": 100, "repeat": [ 2, 2 ] } ] },
        "R": {
          "items": [
            { "item": "still_lab", "chance": 100 },
            { "item": "analytical_set_basic", "chance": 100 },
            { "item": "microcentrifuge", "chance": 100 },
            { "item": "chemistry_set", "chance": 100 },
            { "item": "purifier_smart_shot", "chance": 100 }
          ]
        }
      }
    }
  },
  {
    "type": "mapgen",
    "method": "json",
    "nested_mapgen_id": "lab_finale_loot",
    "weight": 100,
    "object": {
      "mapgensize": [ 3, 3 ],
      "rows": [
        "r  ",
        "r  ",
        "R  "
      ],
      "palettes": [ "lab_palette" ],
      "mapping": {
        "r": { "item": [ { "item": "plut_cell", "chance": 100, "repeat": [ 3, 8 ] } ] },
        "R": {
          "items": [
            { "item": "ammo_heavy_batteries_full", "chance": 100 },
            { "item": "UPS_off", "chance": 100 },
            { "item": "v29", "chance": 100 },
            { "item": "laser_rifle", "chance": 100 },
            { "item": "plasma_gun", "chance": 100 },
            { "item": "plasma", "chance": 100 },
            { "item": "recipe_atomic_battery", "chance": 100 }
          ]
        }
      }
    }
  },
  {
    "type": "mapgen",
    "method": "json",
    "nested_mapgen_id": "lab_finale_loot",
    "weight": 100,
    "object": {
      "mapgensize": [ 3, 3 ],
      "rows": [
        "r  ",
        "r  ",
        "R  "
      ],
      "palettes": [ "lab_palette" ],
      "mapping": {
        "r": { "item": [ { "item": "mininuke", "chance": 100, "repeat": [ 12, 20 ] } ] },
        "R": {
          "item": [ { "item": "recipe_atomic_battery", "chance": 100 }, { "item": "plut_cell", "chance": 100, "repeat": [ 8, 16 ] } ]
        }
      }
    }
  },
  {
    "type": "mapgen",
    "method": "json",
    "nested_mapgen_id": "lab_finale_loot",
    "weight": 100,
    "object": {
      "mapgensize": [ 3, 3 ],
      "rows": [
        "r  ",
        "r  ",
        "R  "
      ],
      "palettes": [ "lab_palette" ],
      "mapping": {
        "r": { "item": [ { "item": "plut_cell", "chance": 100, "repeat": [ 4, 10 ] } ] },
        "R": { "item": [ { "item": "rm13_armor", "chance": 100 }, { "item": "recipe_caseless", "chance": 100 } ] }
      }
    }
  },
  {
    "type": "mapgen",
    "method": "json",
    "nested_mapgen_id": "lab_finale_loot",
    "weight": 100,
    "object": {
      "mapgensize": [ 3, 3 ],
      "rows": [
        "r  ",
        "r  ",
        "r  "
      ],
      "palettes": [ "lab_palette" ],
      "mapping": {
        "r": {
          "items": [
            { "item": "bionics", "chance": 100, "repeat": [ 2, 4 ] },
            { "item": "autodoc_installation_programs_advanced", "chance": 100, "repeat": [ 1, 3 ] }
          ]
        }
      }
    }
  }
]
