[
  {
    "method": "json",
    "om_terrain": [ [ "lab_res_8_SWD_ground", "lab_res_8_SED_ground" ] ],
    "type": "mapgen",
    "weight": 200,
    "object": {
      "fill_ter": "t_thconc_floor",
      "rows": [
        "|||նննննն;;;;;;;;;;;;;;;;;;|||||||||||||||||||||",
        "|||;;;;;ն;££££££££££££££££;|||;;;|;;;|;;;|;;;|||",
        "|||;;;;;ն;£;;£;;;£;;;£;;;£;|||||||||||||||||||||",
        "|||;;è;;ի;£;;;£;;;£;;;£;;£;||£^££££££££££££££|||",
        "|||;;;;;ն;££;;;£;;;£;;;£;£;||£♥♠;;;;;;;;;£;;0|||",
        "|||;;;;;ն;£;£;;;£;;;£;;;££;||£♥♠;;;;;;è;;££££|||",
        "|||նննննն;£;;£;;;£;;;£;;;£;||£♥♠;;;;;;;;;£;;;|||",
        "|||;;;;;ն;£;;;£;;;ä;;;£;;£;||£^££££££;;;;££££|||",
        "|||;;;;;ն;££;;;£;;;£;;;£;£;||;;;;;;;£;;;;£;;;|||",
        "|||;;è;;ի;£;£;;;£;;;£;;;££;||0;;;;;;£;;;;££££|||",
        "|||;;;;;ն;£;;£;;;£;;;£;;;£;|||||||||¥====|||||||",
        "|||;;;;;ն;£;;;£;;;£;;;£;;£;||||||||;£;;;;£||||||",
        "|||նննննն;££££££££££££££££;;;;;;;;;;£;;;;£122|||",
        "|||;;;;;;;;;;;;;;;;;;;;;;;;;;;;;;;;;£;;;;£-22|||",
        "|||;£££££££££££££££££££££££££££££££££;;;;£-22|||",
        "|||;£;;;;;;;;;;;;;;;;;;;;;;;;;;;;;;;;;;;;£||||||",
        "|||;£;;;;;;;;;;;;;;;;;;;;;;;;;;;;;;;;;;;;£|Y>|||",
        "|||;£;;;;;è;;;;;;è;;;;;;è;;;;;;è;;;;;;è;;£|;;|||",
        "|||;£;;;;;;;;;;;;;;;;;;;;;;;;;;;;;;;;;;;;£|=6|||",
        "|||;££££££££££££££££££££££££££££££££££££££;;;|||",
        "|||;;;;;;;;;;;;;;;;;;;;;;;;;;;;;;;;;;;;;;;;;;|||",
        "||||||||||||||||||||||||||||||||||||||||||||||||",
        "||||||||||||||||||||||||||||||||||||||||||||||||",
        "||||||||||||||||||||||||||||||||||||||||||||||||"
      ],
      "palettes": [ "lab_common_palette", "lab_security_palette" ],
      "terrain": { "¥": "t_card_science", "6": "t_card_science" },
      "place_nested": [
        { "chunks": [ [ "lab_cargo_5x5", 100 ] ], "x": 3, "y": 1 },
        { "chunks": [ [ "lab_cargo_5x5", 100 ] ], "x": 3, "y": 7 },
        { "chunks": [ [ "lab_wall_chain_5x5", 50 ], [ "null", 50 ] ], "x": 3, "y": 0 },
        { "chunks": [ [ "lab_wall_chain_5x5", 50 ], [ "null", 50 ] ], "x": 3, "y": 6 }
      ],
      "place_monster": [
        { "monster": "mon_manhack", "x": 30, "y": 1, "chance": 100 },
        { "monster": "mon_skitterbot", "x": 31, "y": 1, "chance": 100 },
        { "monster": "mon_manhack", "x": 32, "y": 1, "chance": 100 },
        { "monster": "mon_flashbang_hack", "x": 34, "y": 1, "chance": 100 },
        { "monster": "mon_manhack", "x": 35, "y": 1, "chance": 100 },
        { "monster": "mon_flashbang_hack", "x": 36, "y": 1, "chance": 100 },
        { "monster": "mon_gasbomb_hack", "x": 38, "y": 1, "chance": 100 },
        { "monster": "mon_secubot", "x": 39, "y": 1, "chance": 100 },
        { "monster": "mon_gasbomb_hack", "x": 40, "y": 1, "chance": 100 },
        { "monster": "mon_manhack", "x": 42, "y": 1, "chance": 100 },
        { "monster": "mon_skitterbot", "x": 43, "y": 1, "chance": 100 },
        { "monster": "mon_manhack", "x": 44, "y": 1, "chance": 100 }
      ]
    }
  },
  {
    "method": "json",
    "om_terrain": [ [ "lab_res_8_SWU_ground", "lab_res_8_SEU_ground" ] ],
    "type": "mapgen",
    "weight": 200,
    "object": {
      "fill_ter": "t_thconc_floor",
      "rows": [
        "|||նննննն;;;;;;;;;;;;;;;;;;|||||||||||||||||||||",
        "|||;;;;;ն;££££££££££££££££;|||;;;|;;;|;;;|;;;|||",
        "|||;;;;;ն;££;;;£;;;£;;;£;£;|||||||||||||||||||||",
        "|||;;è;;ի;£;£;;;£;;;£;;;££;||£^££££££££££££££|||",
        "|||;;;;;ն;£;;£;;;£;;;£;;;£;||£♥♠;;;;;;;;;£;;0|||",
        "|||;;;;;ն;£;;;£;;;£;;;£;;£;||£♥♠;;;;;;è;;££££|||",
        "|||նննննն;££;;;£;;;£;;;£;£;||£♥♠;;;;;;;;;£;;;|||",
        "|||;;;;;ն;£;£;;;ä;;;£;;;££;||£^££££££;;;;££££|||",
        "|||;;;;;ն;£;;£;;;£;;;£;;;£;||;;;;;;;£;;;;£;;;|||",
        "|||;;è;;ի;£;;;£;;;£;;;£;;£;||0;;;;;;£;;;;££££|||",
        "|||;;;;;ն;££;;;£;;;£;;;£;£;|||||||||¥====|||||||",
        "|||;;;;;ն;£;£;;;£;;;£;;;££;||||||||;£;;;;£||||||",
        "|||նննննն;££££££££££££££££;;;;;;;;;;£;;;;£122|||",
        "|||;;;;;;;;;;;;;;;;;;;;;;;;;;;;;;;;;£;;;;£-22|||",
        "|||;£££££££££££££££££££££££££££££££££;;;;£-22|||",
        "|||;£;;;;;;;;;;;;;;;;;;;;;;;;;;;;;;;;;;;;£||||||",
        "|||;£;;;;;;;;;;;;;;;;;;;;;;;;;;;;;;;;;;;;£|>>|||",
        "|||è£;;;;;è;;;;;;è;;;;;;è;;;;;;è;;;;;;è;;£|;;|||",
        "|||;£;;;;;;;;;;;;;;;;;;;;;;;;;;;;;;;;;;;;£|=6|||",
        "|||;££££££££££££££££££££££££££££££££££££££;;;|||",
        "|||;;;;;;;;;;;;;;;;;;;;;;;;;;;;;;;;;;;;;;;;;;|||",
        "||||||||||||||||||||||||||||||||||||||||||||||||",
        "||||||||||||||||||||||||||||||||||||||||||||||||",
        "||||||||||||||||||||||||||||||||||||||||||||||||"
      ],
      "palettes": [ "lab_common_palette", "lab_security_palette" ],
      "terrain": { "¥": "t_card_science", "6": "t_card_science" },
      "place_nested": [
        { "chunks": [ [ "lab_cargo_5x5", 100 ] ], "x": 3, "y": 1 },
        { "chunks": [ [ "lab_cargo_5x5", 100 ] ], "x": 3, "y": 7 },
        { "chunks": [ [ "lab_wall_chain_5x5", 50 ], [ "null", 50 ] ], "x": 3, "y": 0 },
        { "chunks": [ [ "lab_wall_chain_5x5", 50 ], [ "null", 50 ] ], "x": 3, "y": 0 },
        { "chunks": [ [ "lab_wall_chain_5x5", 50 ], [ "null", 50 ] ], "x": 3, "y": 12 }
      ],
      "place_monster": [
        { "monster": "mon_manhack", "x": 30, "y": 1, "chance": 100 },
        { "monster": "mon_skitterbot", "x": 31, "y": 1, "chance": 100 },
        { "monster": "mon_manhack", "x": 32, "y": 1, "chance": 100 },
        { "monster": "mon_flashbang_hack", "x": 34, "y": 1, "chance": 100 },
        { "monster": "mon_manhack", "x": 35, "y": 1, "chance": 100 },
        { "monster": "mon_flashbang_hack", "x": 36, "y": 1, "chance": 100 },
        { "monster": "mon_gasbomb_hack", "x": 38, "y": 1, "chance": 100 },
        { "monster": "mon_secubot", "x": 39, "y": 1, "chance": 100 },
        { "monster": "mon_gasbomb_hack", "x": 40, "y": 1, "chance": 100 },
        { "monster": "mon_manhack", "x": 42, "y": 1, "chance": 100 },
        { "monster": "mon_skitterbot", "x": 43, "y": 1, "chance": 100 },
        { "monster": "mon_manhack", "x": 44, "y": 1, "chance": 100 }
      ],
      "place_vehicles": [ { "vehicle": "golf_cart", "x": [ 8, 20 ], "y": [ 17, 18 ], "chance": 100, "rotation": 90 } ]
    }
  },
  {
    "method": "json",
    "om_terrain": [ [ "lab_CORE_2x1_SED_ground", "lab_CORE_2x1_SWD_ground" ] ],
    "type": "mapgen",
    "weight": 200,
    "object": {
      "fill_ter": "t_thconc_floor",
      "rows": [
        ";QQJJ;;JJQQ;£;;;£;;;£|;;;;Z|;£;;;;;;;£;ն;;;;;|||",
        ";;;;;;;;;;;;£;;;£;;;£ʔr;;hrʔ;£;;;è;;;£;ն;;;;;|||",
        ";;;;;;;;;;;;£;;;£;;;£ʔr;;;rʔ;£;;;;;;;£;ի;;;;;|||",
        ";;;;;;;;;;;;£;;;£;;;£|ʔʔʔʔʔ|;£;;;;;;;£;ն;;;;;|||",
        ";;;;;;;;;;;;£;;;£;;;£;;;;;;;;£;;;;;;;£;ն;;;;;|||",
        ";;;;;;è;;;;;£;;;ä;;;£;;;;è;;;£;;;;;;;£;ն;;;;;|||",
        ";;;;;;;;;;;;£;;;£;;;£;;;;;;;;£;;;;;;;£;ն;;;;;|||",
        ";;;;;;;;;;;;£;;;£;;;£;;;;;;;;£;;;;;;;£;ն;;;;;|||",
        ";;;;;;;;;;;;£;;;£;;;£;;;;;;;;£;;;è;;;£;ի;;;;;|||",
        ";;;;;;;;;;;;£;;;£;;;£;;;;;;;;£;;;;;;;£;ն;;;;;|||",
        "£££££££££££££;£;£;£;££££££££££;;;;;;;£;ն;;;;;|||",
        ";;;;;;;;;;;;;;;;;;;;;;;;;;;;;;;;;;;;;£;ն;;;;;|||",
        ";;;;;;;;;;;;;;;;;;;;;;;;;;;;;;;;;;;;;£;ն;;;;;|||",
        ";;;;;;;;;;;;;;;;;;;;;;;;;;;;;;;;;;;;;£;ն;;;;;|||",
        ";;;;;è;;;;;;è;;;;;;è;;;;;;è;;;;;;è;;;£;ի;;;;;|||",
        ";;;;;;;;;;;;;;;;;;;;;;;;;;;;;;;;;;;;;£;ն;;;;;|||",
        ";;;;;;;;;;;;;;;;;;;;;;;;;;;;;;;;;;;;;£;ն;;;;;|||",
        ";;;;;;;;;;;;;;;;;;;;;;;;;;;;;;;;;;;;;£;նննննն|||",
        "££££££££££££££££££££££££££££££££££££££;;;;;;;|||",
        ";;;;;;;;;;;;;;;;;;;;;;;;;;;;;;;;;;;;;;;;;;;;;|||",
        ";;;;;;;;;;;;;;;;;;;;;;;;;;;;;;;;;;;;;;;;;;;;;|||",
        ";;;;;;;;;;;;;;;;;;;;;;;;;;;;;;;;;;;;;;;;;;;;;|||",
        "|;;;;;;;;;;;;;;;;;;;;;;;;;;;;;;;;;;;;;;;;;;;;|||",
        "|;;;;;;;;;;;;;;;;;;;;;;;;;;;;;;;;;;;;;;;;;;;;|||"
      ],
      "palettes": [ "lab_common_palette", "lab_maintenance_palette" ],
      "place_nested": [
        { "chunks": [ [ "lab_cargo_5x5", 100 ] ], "x": 40, "y": 0 },
        { "chunks": [ [ "lab_cargo_5x5", 100 ] ], "x": 40, "y": 6 },
        { "chunks": [ [ "lab_cargo_5x5", 100 ] ], "x": 40, "y": 12 },
        { "chunks": [ [ "lab_cargo_5x5", 100 ] ], "x": 40, "y": 18 },
        { "chunks": [ [ "lab_cargo_5x5", 100 ] ], "x": 24, "y": 5 },
        { "chunks": [ [ "lab_wall_chain_5x5", 50 ], [ "null", 50 ] ], "x": 40, "y": 5 },
        { "chunks": [ [ "lab_wall_chain_5x5", 50 ], [ "null", 50 ] ], "x": 40, "y": 11 },
        { "chunks": [ [ "lab_wall_chain_5x5", 50 ], [ "null", 50 ] ], "x": 40, "y": 17 }
      ],
      "place_monster": [
        { "monster": "mon_manhack", "x": [ 33, 40 ], "y": [ 2, 22 ], "chance": 100 },
        { "monster": "mon_manhack", "x": [ 2, 22 ], "y": [ 6, 22 ], "chance": 50 }
      ],
      "place_vehicles": [
        { "vehicle": "golf_cart_4seat", "x": 2, "y": 6, "chance": 100, "rotation": 180 },
        { "vehicle": "forklift", "x": 8, "y": 3, "chance": 100, "rotation": 90 },
        { "vehicle": "truck_trailer", "x": 5, "y": 14, "chance": 30, "rotation": 180 },
        { "vehicle": "portable_generator", "x": 5, "y": [ 2, 8 ], "chance": 30, "rotation": 90 },
        { "vehicle": "handjack", "x": 1, "y": [ 2, 8 ], "chance": 30, "rotation": 90 },
        { "vehicle": "forklift", "x": [ 31, 35 ], "y": [ 14, 21 ], "chance": 30, "rotation": 90 },
        { "vehicle": "handjack", "x": [ 40, 44 ], "y": [ 1, 4 ], "chance": 10, "rotation": 0 },
        { "vehicle": "handjack", "x": [ 40, 44 ], "y": [ 8, 10 ], "chance": 10, "rotation": 0 },
        { "vehicle": "handjack", "x": [ 40, 44 ], "y": [ 14, 16 ], "chance": 10, "rotation": 0 },
        { "vehicle": "handjack", "x": [ 40, 44 ], "y": [ 20, 22 ], "chance": 10, "rotation": 0 }
      ],
      "place_loot": [
        { "item": "exosuit_industrial", "x": 6, "y": 14, "chance": 20 },
        { "item": "exosuit_industrial", "x": 6, "y": 14, "chance": 10 }
      ]
    }
  },
  {
    "method": "json",
    "om_terrain": [ [ "lab_CORE_2x1_NED_ground", "lab_CORE_2x1_NWD_ground" ] ],
    "type": "mapgen",
    "weight": 200,
    "object": {
      "fill_ter": "t_thconc_floor",
      "rows": [
        "|;;;;;;;;;;;;;;;;;;;;;;;;;;;;;;;;;;;;;;ն;;;;;|||",
        "|;;;;;;;;;;;;;;;;;;;;;;;;;;;;;;;;;;;;;;ն;;;;;|||",
        ";;;;;;;;;;;;;;;;;;;;;;;;;;;;;;;;;;;;;;;ն;;;;;|||",
        ";;;;;;;;;;;;;;;;;;;;;;;;;;;;;;;;;;;;;;;ի;;;;;|||",
        ";;;;;;;;;;;;;;;;;;;;;;;;;;;;;;;;;;;;;;;ն;;;;;|||",
        "££££££££££££££££££££££££££££££££££££££;ն;;;;;|||",
        ";;;;;;;;;;;;;;;;;;;;;;;;;;;;;;;;;;;;;£;ն;;;;;|||",
        ";;;;;;;;;;;;;;;;;;;;;;;;;;;;;;;;;;;;;£;ն;;;;;|||",
        ";;;;;;;;;;;;;;;;;;;;;;;;;;;;;;;;;;;;;£;ն;;;;;|||",
        ";;;;;è;;;;;;è;;;;;;è;;;;;;è;;;;;;è;;;£;ի;;;;;|||",
        ";;;;;;;;;;;;;;;;;;;;;;;;;;;;;;;;;;;;;£;ն;;;;;|||",
        ";;;;;;;;;;;;;;;;;;;;;;;;;;;;;;;;;;;;;£;ն;;;;;|||",
        ";;;;;;;;;;;;;;;;;;;;;;;;;;;;;;;;;;;;;£;ն;;;;;|||",
        "£££££££££££££;£;£;£;££££££££££;;;;;;;£;ն;;;;;|||",
        ";;;;;;;;;;;;£;;;£;;;£;;;;;;;;£;;;;;;;£;ն;;;;;|||",
        ";;;;;;;;;;;;£;;;£;;;£;;;;;;;;£;;;;;;;£;ի;;;;;|||",
        ";;;;;;;;;;;;£;;;£;;;£;;;;;;;;£;;;è;;;£;ն;;;;;|||",
        ";;;;;;;;;;;;£;;;£;;;£;;;;;;;;£;;;;;;;£;ն;;;;;|||",
        ";;;;;;è;;;;;£;;;ä;;;£;;;è;;;;£;;;;;;;£;ն;;;;;|||",
        ";;;;;;;;;;;;£;;;£;;;£;;;;;;;;£;;;;;;;£;ն;;;;;|||",
        ";;;;;;;;;;;;£;;;£;;;£|ʔʔʔʔʔ|;£;;;;;;;£;ն;;;;;|||",
        ";;;;;;;;;;;;£;;;£;;;£ʔr;;hrʔ;£;;;;;;;£;ի;;;;;|||",
        ";;;;;;;;;;;;£;;;£;;;£ʔr;;;rʔ;£;;;;;;;£;ն;;;;;|||",
        ";QQJJ;;JJQQ;£;;;£;;;£|;;;;Z|;£;;;è;;;£;ն;;;;;|||"
      ],
      "palettes": [ "lab_common_palette", "lab_maintenance_palette" ],
      "place_nested": [
        { "chunks": [ [ "lab_cargo_5x5", 100 ] ], "x": 40, "y": 0 },
        { "chunks": [ [ "lab_cargo_5x5", 100 ] ], "x": 40, "y": 6 },
        { "chunks": [ [ "lab_cargo_5x5", 100 ] ], "x": 40, "y": 12 },
        { "chunks": [ [ "lab_cargo_5x5", 100 ] ], "x": 40, "y": 18 },
        { "chunks": [ [ "lab_cargo_5x5", 100 ] ], "x": 24, "y": 14 },
        { "chunks": [ [ "lab_wall_chain_5x5", 50 ], [ "null", 50 ] ], "x": 40, "y": 5 },
        { "chunks": [ [ "lab_wall_chain_5x5", 50 ], [ "null", 50 ] ], "x": 40, "y": 11 },
        { "chunks": [ [ "lab_wall_chain_5x5", 50 ], [ "null", 50 ] ], "x": 40, "y": 17 }
      ],
      "place_monster": [
        { "monster": "mon_manhack", "x": [ 33, 40 ], "y": [ 2, 22 ], "chance": 100 },
        { "monster": "mon_manhack", "x": [ 2, 22 ], "y": [ 2, 18 ], "chance": 50 }
      ],
      "place_vehicles": [
        { "vehicle": "truck_trailer", "x": 5, "y": 8, "chance": 30, "rotation": 180 },
        { "vehicle": "portable_generator", "x": 5, "y": [ 18, 21 ], "chance": 30, "rotation": 90 },
        { "vehicle": "handjack", "x": 1, "y": [ 18, 21 ], "chance": 30, "rotation": 90 },
        { "vehicle": "forklift", "x": 8, "y": 19, "chance": 30, "rotation": 0 },
        { "vehicle": "forklift", "x": [ 31, 35 ], "y": [ 14, 21 ], "chance": 30, "rotation": 90 },
        { "vehicle": "handjack", "x": [ 40, 44 ], "y": [ 1, 4 ], "chance": 10, "rotation": 0 },
        { "vehicle": "handjack", "x": [ 40, 44 ], "y": [ 8, 10 ], "chance": 10, "rotation": 0 },
        { "vehicle": "handjack", "x": [ 40, 44 ], "y": [ 14, 16 ], "chance": 10, "rotation": 0 },
        { "vehicle": "handjack", "x": [ 40, 44 ], "y": [ 20, 22 ], "chance": 10, "rotation": 0 }
      ]
    }
  },
  {
    "method": "json",
    "om_terrain": [ [ "lab_CORE_2x1_WC_ground", "lab_CORE_2x1_EC_ground" ] ],
    "type": "mapgen",
    "weight": 200,
    "object": {
      "fill_ter": "t_thconc_floor",
      "rows": [
        "|||||||||||||===¥===||#|;hrʔ;£;;;;;;;£;նննննն|||",
        "|;;;;;;;;;;;£;;;£;;;£;;|;;rʔ;£;;;;;;;£;ն;;;;;|||",
        "|;è;;;;;;;;;£;;;£;;;£;;||ʔʔ|;£;;;;;;;£;ն;;;;;|||",
        "|#||||;;;;;;£;;;£;;;£;;|;;;;;£;;;;;;;£;ի;;;;;|||",
        "|;;QQ|Q;;;;;£;£;£;£;£;;|;;;;;£;;;;;;;£;ն;;;;;|||",
        "|;è;J|;;;;;;;;;;;;;;;;;|;;;;;£;;;;;;;£;ն;;;;;|||",
        "|;;QQ|||||;;;;;;;;;;;;;|;;;;;£;;;è;;;£;նննննն|||",
        "||;|||Phrʔ;;;;;;;;;;;;q|;;;;;£;;;;;;;£;ն;;;;;|||",
        "|R;;;+;èrʔ;;;;;;è;;;;;q|;;;;;£;;;;;;;£;ն;;;;;|||",
        "|R;;;|y;;ʔ;;;;;;;;;;;;Q|;;;;;£;;;;;;;£;ն;;;;;|||",
        "|;;;;|+|||ʋ;;ʍ;;;;;;;;J|||;;;£;;;;;;;£;ն;;;;;|||",
        "|3;;H|;;t|N;AN;;;;;;;;J|;|;;;£;;;;;;;£;ի;;;;;|||",
        "|Y;;H|;SY|N;;N;;;;;;;;J|;|;;;£;;;;;;;£;ի;;;;;|||",
        "|4;;H|+|||ã;;ʉ;;;;;;;;J|||;;;£;;;è;;;£;ն;;;;;|||",
        "|;;;;|;;;ʔ;;;A;;;;;;;;Q|;;;;;£;;;;;;;£;ն;;;;;|||",
        "|y;E;+;èhʔ;;;;;;è;;;;;q|;;;;;£;;;;;;;£;ն;;;;;|||",
        "||;|||Prrʔ;;;;;;;;;;;;q|;;;;;£;;;;;;;£;ն;;;;;|||",
        "|;;qq|||||;;;;;;;;;;;;;|;;;;;£;;;;;;;£;նննննն|||",
        "|;è;J|;;;;;;;;;;;;;;;;;|;;;;;£;;;;;;;£;ն;;;;;|||",
        "|;;qq|Q;;;;;£;£;£;£;£;;|;;;;;£;;;è;;;£;ն;;;;;|||",
        "|#||||;;;;;;£;;;£;;;£;;|;;;;;£;;;;;;;£;ի;;;;;|||",
        "|;è;;;;;;;;;£;;;£;;;£;;||ʔʔ|;£;;;;;;;£;ն;;;;;|||",
        "|;;;;;;;;;;;£;;;£;;;£;;|;;rʔ;£;;;;;;;£;ն;;;;;|||",
        "|||||||||||||===¥===||#|;hrʔ;£;;;;;;;£;նննննն|||"
      ],
      "palettes": [ "lab_common_palette", "lab_maintenance_palette" ],
      "terrain": { "¥": "t_card_science" },
      "place_monster": [
        { "monster": "mon_manhack", "x": [ 27, 40 ], "y": [ 2, 22 ], "chance": 100 },
        { "monster": "mon_skitterbot", "x": 24, "y": 11, "chance": 100 },
        { "monster": "mon_skitterbot", "x": 24, "y": 12, "chance": 100 }
      ],
      "place_nested": [
        { "chunks": [ [ "lab_cargo_5x5", 100 ] ], "x": 40, "y": 1 },
        { "chunks": [ [ "lab_cargo_5x5", 100 ] ], "x": 40, "y": 7 },
        { "chunks": [ [ "lab_cargo_5x5", 100 ] ], "x": 40, "y": 12 },
        { "chunks": [ [ "lab_cargo_5x5", 100 ] ], "x": 40, "y": 18 },
        { "chunks": [ [ "lab_wall_chain_5x5", 50 ], [ "null", 50 ] ], "x": 40, "y": 1 },
        { "chunks": [ [ "lab_wall_chain_5x5", 50 ], [ "null", 50 ] ], "x": 40, "y": 6 },
        { "chunks": [ [ "lab_wall_chain_5x5", 50 ], [ "null", 50 ] ], "x": 40, "y": 17 },
        { "chunks": [ [ "lab_wall_chain_5x5", 50 ], [ "null", 50 ] ], "x": 40, "y": 23 }
      ],
      "items": {
        "R": { "item": "SUS_engineering_bookcase", "chance": 30 },
        "Q": { "item": "gas_charging_rack", "chance": 30 },
        "J": [ { "item": "mechanics", "chance": 30 } ],
        "N": [ { "item": "mechanics", "chance": 30 } ],
        "q": [ { "item": "mechanics", "chance": 30 } ]
      },
      "place_loot": [
        { "item": "id_science", "x": 6, "y": 7, "chance": 100 },
        { "item": "id_science", "x": 6, "y": 16, "chance": 100 },
        { "item": "hd_tow_cable", "x": 22, "y": [ 7, 8 ], "chance": 10 },
        { "item": "jumper_cable", "x": 22, "y": [ 7, 8 ], "chance": 10 },
        { "item": "jumper_cable_heavy", "x": 22, "y": [ 7, 8 ], "chance": 7 },
        { "item": "folding_basket", "x": 22, "y": [ 10, 13 ], "chance": 5 },
        { "item": "bike_basket", "x": 22, "y": [ 10, 13 ], "chance": 5 },
        { "item": "bike_rack", "x": 22, "y": [ 10, 13 ], "chance": 7 },
        { "item": "mounted_spare_tire", "x": 22, "y": [ 10, 13 ], "chance": 10 },
        { "item": "cargo_lock", "x": 22, "y": [ 10, 13 ], "chance": 25 },
        { "item": "cargo_rack", "x": 22, "y": [ 10, 13 ], "chance": 10 },
        { "item": "animal_locker", "x": 22, "y": [ 10, 13 ], "chance": 15 },
        { "item": "toolbox", "x": 22, "y": [ 10, 13 ], "chance": 5 },
        { "item": "vac_sealer", "x": 22, "y": [ 10, 13 ], "chance": 5 },
        { "item": "dehydrator", "x": 22, "y": [ 10, 13 ], "chance": 5 },
        { "item": "water_purifier", "x": 22, "y": [ 10, 13 ], "chance": 5 },
        { "item": "food_processor", "x": 22, "y": [ 10, 13 ], "chance": 5 },
        { "item": "press", "x": 22, "y": [ 10, 13 ], "chance": 5 },
        { "item": "puller", "x": 22, "y": [ 10, 13 ], "chance": 5 },
        { "item": "forgerig", "x": 22, "y": [ 10, 13 ], "chance": 2 },
        { "item": "toolbox_workshop", "x": 22, "y": [ 10, 13 ], "chance": 5 },
        { "item": "welder", "x": 22, "y": [ 10, 13 ], "chance": 5 },
        { "item": "soldering_iron", "x": 22, "y": [ 10, 13 ], "chance": 5 },
        { "item": "v_table", "x": 22, "y": [ 10, 13 ], "chance": 7 },
        { "item": "towel_hanger", "x": 22, "y": [ 10, 13 ], "chance": 10 },
        { "item": "workbench", "x": 22, "y": [ 10, 13 ], "chance": 7 },
        { "item": "recharge_station", "x": 22, "y": [ 15, 16 ], "chance": 15 },
        { "item": "minifreezer", "x": 22, "y": [ 15, 16 ], "chance": 10 },
        { "item": "mountable_heater", "x": 22, "y": [ 15, 16 ], "chance": 10 },
        { "item": "mountable_cooler", "x": 22, "y": [ 15, 16 ], "chance": 10 }
      ],
      "place_vehicles": [
        { "vehicle": "quad_bike_chassis", "x": 20, "y": 8, "chance": 30, "rotation": 90 },
        { "vehicle": "engine_crane", "x": 15, "y": 11, "chance": 30, "rotation": 0 },
        { "vehicle": "welding_cart", "x": 17, "y": [ 12, 14 ], "chance": 30, "rotation": 180 },
        { "vehicle": "motorcycle_chassis", "x": 8, "y": 19, "chance": 30, "rotation": 180 }
      ]
    }
  },
  {
    "method": "json",
    "om_terrain": [ [ "lab_2x1_CORE_-1W", "lab_2x1_CORE_-1E" ] ],
    "//": "level -1 for cargo ramps. TODO: complete this level for maintenance expansion.",
    "type": "mapgen",
    "weight": 200,
    "object": {
      "fill_ter": "t_thconc_floor",
      "rows": [
        "??????????||||||||||||||||||||||||||||||||||||||",
        "??????????||||||||||||||||||||||||||||||||||||||",
        "??????????||||||||||||||||||||||||||||||||||||||",
        "??????????||||;;;;;;;;;;;;;;;;;;;;;;;;;;;;;|||||",
        "??????????||||;;♠♥;;;;;;;;;;;;♣♦;;;;;;;;;;;|||||",
        "??????????||||;;♠♥;;;;;è;;;;;;♣♦;è;;;;;;;;;|||||",
        "??????????||||;;♠♥;;;;;;;;;;;;♣♦;;;;;;;;;;;|||||",
        "??????????||||;;;;;;;;;;;;;;;;;;;;;;;;;;;;;|||||",
        "??????????||||||||||||||||||||||||||||||||||||||",
        "??????????||||||||||||||||||||||||||||||||||||||",
        "??????????||||||||||||||||||||||||||||||||||||||",
        "??????????||||||||||||||||||||||||||||||||||||||",
        "??????????|||||||||||||||||||||||||||||;;;122|||",
        "??????????|||||||||||||||||||||||||||||;è;-22|||",
        "??????????|||||||||||||||||||||||||||||;;;-22|||",
        "??????????|||||||||||||||||||||||||||||;;;||||||",
        "??????????|||||||||||||||||||||||||||||;è;|><|||",
        "??????????|||||||||||||||||||||||||||||;;;#;;|||",
        "??????????||||||||||||||||||||||||||||||||||||||",
        "??????????||||||||||||||||||||||||||||||||||||||",
        "??????????||||||||||||||||||||||||||||||||||||||",
        "??????????||||||||||||||||||||||||||||||||||||||",
        "??????????||||||||||||||||||||||||||||||||||||||",
        "??????????????????????????????????||||??????????"
      ],
      "palettes": [ "lab_common_palette", "lab_maintenance_palette" ],
      "terrain": { "?": "t_rock" }
    }
  }
]
