[
  {
    "method": "json",
    "om_terrain": "house_26",
    "//": "used by basement_survival",
    "type": "mapgen",
    "weight": 100,
    "object": {
      "fill_ter": "t_floor",
      "rows": [
        "......p`................",
        "....%%```%%....%%%......",
        ".###oo#*#oo#####o####...",
        ".#TE    L      R RRR#...",
        ".#x  H            hro...",
        ".#x lH        yP   r#...",
        ".#x  H        |||+||###.",
        ".o            |y     T#.",
        ".#  AAA A     |D    @@o.",
        ".#JJJJJJJ    6|d    @@o.",
        ".o4          6|TEs   I#.",
        ".#F12357OY    ||||#####.",
        ".#||||||||||  |QBB#^....",
        ".oI  T@@   +  +¨¨8o.....",
        ".oIh  @@   |  |t¨S#.....",
        ".#||     Ey|  ||||###...",
        ".#D+  ||||||   RRR >#...",
        ".###db|U |y        y#...",
        "...####U +  EsET ####...",
        ".....^###o#oo#o###......",
        "........................",
        "........................",
        "........................",
        "........................"
      ],
      "palettes": [ "standard_domestic_palette", "parameterized_linoleum_color_bathroom", "standard_domestic_landscaping_palette" ]
    }
  },
  {
    "type": "mapgen",
    "method": "json",
    "om_terrain": "house_26_roof",
    "object": {
      "fill_ter": "t_shingle_flat_roof",
      "rows": [
        "                        ",
        "                        ",
        " --------------------   ",
        " -..................-   ",
        " -..................-   ",
        " -..................-   ",
        " -.....:............--- ",
        " -....................- ",
        " -.............N......- ",
        " -....................- ",
        " -......X.............- ",
        " -................5---- ",
        " -................-     ",
        " -................-     ",
        " -................-     ",
        " -.........=.&....---   ",
        " -..................-   ",
        " ---................-   ",
        "   ---5..........----   ",
        "      ------------      ",
        "                        ",
        "                        ",
        "                        ",
        "                        "
      ],
      "palettes": [ "roof_palette" ],
      "terrain": { ".": "t_shingle_flat_roof" }
    }
  }
]
