[
  {
    "type": "mapgen",
    "method": "json",
    "om_terrain": [ "house_garage6" ],
    "weight": 200,
    "//": "two bedroom one bath single garage home.",
    "object": {
      "fill_ter": "t_floor",
      "rows": [
        "..........```.``````````",
        "...!!%%%!p.`.M``````%!!`",
        "..##oooo##%`%#======##!`",
        "..#,˙˙˙˙,#$?$#~~~~~~&#!`",
        "..#˙˙//˙˙#!`!#~~~~~~~#!`",
        ".%o˙˙ff˙˙o%`%o~~~~~~~#%`",
        ".%o˙˙//˙˙o%`%o~~~~~~~*``",
        ".^#˙˙˙˙˙˙#!`!#~~~~~~q#!.",
        "..#347˙˙6#!`!#~~~~~~q#..",
        "..#F˙˙˙˙˙o%`%o~~~~~~No%.",
        ".!#O˙˙J˙˙o%`%o~~~~~~No%.",
        ".%o5˙˙J˙6#!`!#q~WZqqq#..",
        ".!#1˙˙˙˙˙#%`%#|+|||||#..",
        "..#|JJJ˙˙#:*:#s y|S8t#!.",
        ".!#yAA A         +¨¨¨o%.",
        ".`*      |y>r||+||BB¨#!.",
        ".!# sHH  |||||   |||+#..",
        ".%o H    | dR| h     #..",
        ".%o H l  +   |II   @@o%.",
        "..#      |h  |||T  @@o%.",
        "..#y    y|II @@|Dd  R#..",
        "..##:¶¶:###o#o####o###..",
        "...``````.!%.%!...%.^...",
        "....````................"
      ],
      "palettes": [
        "standard_domestic_palette",
        "parameterized_linoleum_color_kitchen",
        "parameterized_linoleum_color_bathroom",
        "standard_domestic_landscaping_palette"
      ],
      "terrain": {
        "M": "t_region_groundcover_urban",
        "&": "t_gates_mech_control",
        "=": "t_door_metal_locked",
        "~": "t_thconc_floor",
        "q": "t_thconc_floor",
        "W": "t_thconc_floor",
        "Z": "t_thconc_floor",
        "N": "t_thconc_floor",
        "?": "t_fencegate_c",
        "$": "t_fence",
        "f": { "param": "linoleum_color_kitchen", "fallback": "t_linoleum_white" },
        "/": { "param": "linoleum_color_kitchen", "fallback": "t_linoleum_white" },
        ",": { "param": "linoleum_color_kitchen", "fallback": "t_linoleum_white" }
      },
      "furniture": { "M": "f_sign", ",": [ "f_indoor_plant", "f_indoor_plant_y" ], "/": "f_chair" },
      "place_loot": [
        { "group": "child_items", "x": [ 10, 12 ], "y": [ 17, 20 ], "chance": 80, "repeat": [ 1, 3 ] },
        { "group": "school", "x": [ 10, 10 ], "y": [ 20, 20 ], "chance": 70, "repeat": [ 1, 2 ] },
        { "group": "tools_carpentry", "x": [ 14, 14 ], "y": [ 11, 11 ], "chance": 30, "repeat": [ 1, 2 ] },
        { "group": "home_hw", "x": [ 20, 20 ], "y": [ 7, 10 ], "chance": 70, "repeat": [ 1, 4 ] },
        { "item": "hose", "x": [ 12, 12 ], "y": [ 22, 22 ], "chance": 75 }
      ],
      "place_monsters": [ { "monster": "GROUP_ZOMBIE", "x": [ 2, 21 ], "y": [ 2, 21 ], "chance": 2 } ],
      "place_vehicles": [ { "vehicle": "suburban_home", "x": 17, "y": 7, "chance": 10, "rotation": 90 } ]
    }
  },
  {
    "type": "mapgen",
    "method": "json",
    "om_terrain": "house_garage6_roof",
    "object": {
      "fill_ter": "t_shingle_flat_roof",
      "rows": [
        "                        ",
        "                        ",
        "  --------   ---------  ",
        "  -......-   -.......-  ",
        "  -......-   -.......-  ",
        "  -......-   -.......-  ",
        "  -......-   -.......-  ",
        "  5......-   -.......-  ",
        "  -......-   -.......-  ",
        "  -......-   -.......-  ",
        "  -...&..-   -.......-  ",
        "  -......-   -.......-  ",
        "  -......-   -...X...-  ",
        "  -......-----.......-  ",
        "  -..................-  ",
        "  -..................-  ",
        "  -..................-  ",
        "  -............=.....-  ",
        "  -...N..............-  ",
        "  -..................-  ",
        "  -..................-  ",
        "  -----------------5--  ",
        "                        ",
        "                        "
      ],
      "palettes": [ "roof_palette" ],
      "terrain": { ".": "t_shingle_flat_roof" }
    }
  },
  {
    "type": "mapgen",
    "method": "json",
    "om_terrain": "house_garage6_basement",
    "object": {
      "fill_ter": "t_thconc_floor",
      "rows": [
        "                        ",
        "                        ",
        "  ||||||||   |||||||||  ",
        "  |2.....|   |3......|  ",
        "  |......|   |.......|  ",
        "  |......|   |.......|  ",
        "  |......|   |.......|  ",
        "  |......|   |.......|  ",
        "  |......|   |.......|  ",
        "  |.....Z|   |.......|  ",
        "  |F....J|   |.......|  ",
        "  |.....W|   |.......|  ",
        "  |..A..g|   |.......|  ",
        "  |......|||||.......|  ",
        "  |..................|  ",
        "  |1.....%.<.%.4.....|  ",
        "  |......%%%%%.......|  ",
        "  |.......zz.z.......|  ",
        "  |..........z.......|  ",
        "  |..................|  ",
        "  |..................|  ",
        "  ||||||||||||||||||||  ",
        "                        ",
        "                        "
      ],
      "palettes": [ "basement_empty" ],
      "nested": {
        "1": {
          "chunks": [
            [ "null", 70 ],
            [ "room_6x6_guns_N", 10 ],
            [ "room_6x6_guns_E", 10 ],
            [ "room_6x6_office_E", 40 ],
            [ "room_6x6_brewer_E", 20 ],
            [ "room_6x6_brewer_N", 20 ],
            [ "room_6x6_junk", 50 ]
          ]
        },
        "2": {
          "chunks": [
            [ "null", 70 ],
            [ "room_6x6_woodworker", 10 ],
            [ "room_6x6_guns_S", 5 ],
            [ "room_6x6_brewer_S", 10 ],
            [ "room_6x6_bike", 20 ]
          ]
        },
        "3": { "chunks": [ [ "null", 95 ], [ "7x7_tent_indoors", 5 ], [ "room_7x7_recroom_S", 20 ] ] },
        "4": {
          "chunks": [
            [ "null", 80 ],
            [ "5x5_holdout_N", 2 ],
            [ "5x5_holdout_W", 2 ],
            [ "5x5_gym_N", 20 ],
            [ "5x5_gym_S", 20 ],
            [ "5x5_gym_E", 20 ],
            [ "5x5_gym_W", 20 ],
            [ "livingroom_5x5_S_1", 30 ],
            [ "livingroom_5x5_E_1", 30 ],
            [ "livingroom_5x5_N_1", 30 ],
            [ "livingroom_5x5_W_1", 30 ],
            [ "livingroom_5x5_S_2", 30 ],
            [ "livingroom_5x5_E_2", 30 ],
            [ "livingroom_5x5_N_2", 30 ],
            [ "livingroom_5x5_W_2", 30 ],
            [ "home_office_4x4_N", 20 ],
            [ "home_office_4x4_S", 20 ]
          ]
        }
      }
    }
  }
]
