[
  {
    "method": "json",
    "om_terrain": "house_29",
    "//": "used by basement_chem",
    "type": "mapgen",
    "weight": 100,
    "object": {
      "fill_ter": "t_floor",
      "rows": [
        "..........``p...........",
        "..........``............",
        "..........``.....X......",
        "...`````````............",
        "...`......```````````...",
        "...`..%%.```..%%....`...",
        "...`..####*###o###..`...",
        "...`..#xxy L|@d y#..`...",
        "...`..o l   |@  Io..`...",
        "...`..#HHH  |  hIo..`...",
        "...`..#RRT  |    #..`...",
        "...`.%#     + ybD#$$;$$$",
        "$$$;$%o hfh |||||#..`..$",
        "$..`.%o hfh  |QBB#..`..$",
        "$..`.%#      +¨¨¨o..`..$",
        "$..`..#5    Y|t8S#..`..$",
        "$..`..#O    7#####..`..$",
        "$..`..o4    6#^jj%..`..$",
        "$..`..#F123 >#......`..$",
        "$..`..##oo#*##..[...`..$",
        "$..`.......`........`..$",
        "$..``````````````````..$",
        "$......................$",
        "$$$$$$$$$$$$$$$$$$$$$$$$"
      ],
      "palettes": [ "standard_domestic_palette", "parameterized_linoleum_color_bathroom", "standard_domestic_landscaping_palette" ],
      "terrain": { "$": "t_privacy_fence", ";": "t_privacy_fencegate_c" }
    }
  },
  {
    "type": "mapgen",
    "method": "json",
    "om_terrain": "house_29_roof",
    "object": {
      "fill_ter": "t_shingle_flat_roof",
      "rows": [
        "                        ",
        "                        ",
        "                        ",
        "                        ",
        "                        ",
        "                        ",
        "      ------------      ",
        "      -..........-      ",
        "      -..........-      ",
        "      -..........-      ",
        "      -..........-      ",
        "      -..........-      ",
        "      -..........-      ",
        "      -..........-      ",
        "      -..........-      ",
        "      -..........-      ",
        "      -......5----      ",
        "      -......-          ",
        "      -......-          ",
        "      --------          ",
        "                        ",
        "                        ",
        "                        ",
        "                        "
      ],
      "palettes": [ "roof_palette" ],
      "terrain": { ".": "t_shingle_flat_roof" }
    }
  }
]
