[
  {
    "method": "json",
    "om_terrain": "house_31",
    "//": "used by legacy basements including lab basements, no dedicated stairs added.",
    "type": "mapgen",
    "weight": 100,
    "object": {
      "fill_ter": "t_floor",
      "rows": [
        "######....``.....`````..",
        "#Tii #..[.``..X..`````..",
        "#    *``````.....`````..",
        "#y  L#..%%%%..^..`````..",
        "#:¶¶:####::::####=====##",
        "#y   EsE  s   y#~~~~~~&#",
        "#r        H   x#~~~~~~~#",
        "#r        Hl  x#~~~~~~~#",
        "#         H   x#~~~~~~~#",
        ":  hhhh        #~~~~~~~#",
        ":  ffff        +~~~~~~~#",
        ":  hhhh        #U~NN~~q#",
        "#        RRT   #########",
        "#6  Y||||||||   | I@@I #",
        "#6  J|RIII  +   +  @@  o",
        "o7  J|  h   ||+||     b#",
        "#O  J|y    d|¨¨t|d yE  o",
        "o3  4|@@   T|B¨¨||+||  #",
        "#F152|I  E d|B8S|S¨t|DD#",
        "###o###o##o###o#########",
        "..%%%........%%%...^....",
        "........[...............",
        ".....[......[...........",
        "...................%...."
      ],
      "palettes": [ "standard_domestic_palette", "parameterized_linoleum_color_bathroom", "standard_domestic_landscaping_palette" ],
      "terrain": {
        "$": "t_privacy_fence",
        ";": "t_privacy_fencegate_c",
        "&": "t_gates_mech_control",
        "=": "t_door_metal_locked",
        "U": "t_thconc_floor",
        "q": "t_thconc_floor",
        "N": "t_thconc_floor",
        "~": "t_thconc_floor"
      }
    }
  },
  {
    "type": "mapgen",
    "method": "json",
    "om_terrain": "house_31_roof",
    "object": {
      "fill_ter": "t_shingle_flat_roof",
      "rows": [
        "------                  ",
        "-....-                  ",
        "-....-                  ",
        "-....-                  ",
        "-....---------5---------",
        "-......................-",
        "-......................-",
        "-......................-",
        "-......................-",
        "-......................-",
        "-......................-",
        "-....X......N..........-",
        "-......................-",
        "-......................-",
        "-....................=.-",
        "-............&.........-",
        "-......................-",
        "-......................-",
        "-......................-",
        "-------------------5----",
        "                        ",
        "                        ",
        "                        ",
        "                        "
      ],
      "palettes": [ "roof_palette" ],
      "terrain": { ".": "t_shingle_flat_roof" }
    }
  }
]
